F F F F F F F F F F F F F F F F
F W W W W W W W W W W W W W W F
F W F F F F F F F F F F F F W F
F W F F F F F F F F F F F F W F
F W F F F F F F F F F F F F W F
F W F F F F F F F F G F F F W F
F W F F F F F F F F F F F F W F
F W F F F F F F F F F F F F W F
F W F F F F F F F F F F F F W F
F W F F F F F F F F F F F F W F
F W F F F F F F F F F F F F W F
F W F F F F F F F F F F F F W F
F W F F F F F F F F F F F F W F
F W F F F F F F F F F F F F W F
F W W W W W W W W W W W W W W F
F F F F F F F F F F F F F F F F